NO way to north
SO way to South
WE way to west 
EA way to east 

F color floor
C color ceiling

on peut mettre ce a qu on veut ici 

11111111111111111111111       11111
10000000000000000000001111111110001
10000000000000000000000000000000001
100000            00001111111111001
1          0000000011111       1001
10000000000000000000001        1111
10000000000000000N00001
11111111111110111111111
            101
            101
111111111111101111111111111111111111111111111111111111111
100000000000000000000000000000000000000000000000000000001
111111111111111111111111111111111111111111111111111111111