NO ./texture/marbface_64_64.xpm
SO ./texture/marbface_2_64_64.xpm
WE ./texture/marbface_3_64_64.xpm
EA ./texture/mur_lamp_64_64.xpm

F 109,7,26
C 203,10,45

on peut mettre ce a qu on veut ici 

11111111111111111111111       11111
100000000000Y0000000001111111110001
10000000000Y0000000Y000000000000001
100000  1Y         0001111111111001
1         0000000000001        1001
10000000000000000000001        1111
10000000000000000WY0001
11111111111110111111111
            101
            101
            101
            101
            101
            101
            101
            101
            101
            101
            101
111111111111101111111111111111
100000000000000000000000000001
100000000000000000000000000001
100000000000000000000000000001
100000000000001111110000000011
111111111111111111111111111111